11111000000000000000
00011000000000000000
00011000000000000000
00011000000000000001
00011000000000000001
00011111100000000001
00000000100000000001
00000000100000000001
00000000111111111111
00000000000000000000
00000000000000000000
00000000000000000000
00000000000000000000
00000000000000000000
00000000000000000000
00000000000000000000
00000000000000000000
00000000000000000000
00000000000000000000
00000000000000000000
