00000000000000000000
00000000000000000000
00000000000000000000
00000000000000000000
00000000000000000000
00000000000000000000
11000000000000000000
01111111111111111111
00000000100000000000
00000000101000010000
00000000000000000000
00000010000010000000
00000000000000001000
00000000001001010000
00000010000000000000
00000000100010000000
00000000000000000000
00000000000000000000
00000000000000000000
00000000000000000000
